30 30
0 0 0 0 0 0 0 0 1 1 1 0 0 0 0 0 0
0 0 0 0 0 0 0 0 1 4 1 0 0 0 0 0 0
0 0 0 0 0 0 0 0 1 0 1 0 0 0 0 0 0
0 0 0 0 0 0 0 0 1 0 1 0 0 0 0 0 0
0 0 0 0 0 0 0 0 1 0 1 0 0 0 0 0 0
0 0 0 0 1 1 1 1 1 0 1 0 0 0 0 0 0
0 0 0 0 1 6 0 0 0 0 1 0 0 0 0 0 0
0 0 0 0 1 0 0 1 1 1 1 0 0 0 0 0 0
0 0 0 0 1 0 0 1 1 0 0 0 0 0 0 0 0
0 0 0 0 1 0 0 0 1 0 0 0 0 0 0 0 0
0 0 0 0 1 1 1 5 1 0 0 0 0 0 0 0 0
0 0 0 0 0 0 1 5 1 0 0 0 0 0 0 0 0
0 0 0 0 0 0 1 5 1 0 0 0 0 0 0 0 0
0 0 0 0 1 1 1 5 1 1 1 0 0 0 0 0 0
0 0 0 0 1 0 0 0 0 0 1 0 0 0 0 0 0
0 0 0 0 1 0 0 0 1 0 1 0 0 0 0 0 0
0 0 0 0 1 0 0 0 1 5 1 0 0 0 0 0 0
0 0 0 0 1 6 0 0 1 5 1 0 0 0 0 0 0
0 0 0 1 1 1 1 1 1 5 1 0 0 0 0 0 0
0 0 0 1 0 0 0 0 1 5 1 0 0 0 0 0 0
0 0 0 1 0 1 1 0 1 0 1 0 0 0 0 0 0
0 0 0 1 0 1 1 0 0 0 1 0 0 0 0 0 0
0 0 0 1 0 1 1 1 1 1 1 0 0 0 0 0 0
1 1 1 1 0 1 1 1 1 1 1 1 1 1 1 1 1
1 0 0 0 0 0 0 0 0 0 1 1 0 0 0 0 1
1 0 0 0 0 1 1 1 1 0 0 0 0 0 0 0 1
1 0 0 0 0 1 0 0 1 1 1 1 1 0 0 5 1
1 0 0 0 6 1 0 0 0 3 0 0 0 0 0 5 1
1 1 1 1 1 1 0 0 0 3 0 0 2 0 0 4 1
0 0 0 0 0 0 0 0 0 3 3 1 1 1 1 1 1