12 30
111111111111111111111111111111
120001111111111111111111111111
101101111111111111111111111111
101001111111111111111111111111
101011111111111111111111111111
101011111111111111111111111111
101011111111111111111111111111
101011111111111111111111111111
101011111111111111111111111111
101011111111111111111111111111
101000000000000000000000000001
111111111111111111111111111111